Цикунов	Валерий	Николаевич	АВТ-1
Кораблев	Николай	Васильевич	АВТ-1
Лыков	Сергей	Вячеславович	АВТ-1
Ремезов	Николай	Никодимович	АВТ-1
Новожилов	Алексей	Сергеевич	АВТ-1
Голендеев	Сергей	Генадьевич	АВТ-1
Нуженков	Александр	Петрович	АВТ-1
Большаков	Владимир	Михайлович	АВТ-1
Тузков	Евгений	Сергеевич	АВТ-1
Ильин	Владимир	Борисович	АВТ-1
Марунин	Сергей	Леонидович	АВТ-1
Белобородов	Сергей	Анатольевич	АВТ-1
Филатов	Григорий	Михайлович	АВТ-1
Решетников	Леонид	Петрович	АВТ-1
Коновалов	Александр	Сергеевич	АВТ-1
Осетров	Николай	Владимирович	АВТ-1
Кисляков	Андрей	Семёнович	АВТ-1
Таланин	Владимир	Аркадевич	АВТ-1
Щипанов	Анатолий	Александрович	АВТ-1
Казанов	Александр	Александрович	АВТ-1
Ерофеев	Сергей	Евгеньевич	АВТ-1
Фомин	Анатолий	Витальевич	АВТ-1
Воронин	Дмитрий	Владимирович	АВТ-1
Самсонов	Александр	Вячеславович	АВТ-1
Малеев	Александр	Александрович	АВТ-1
Ясаков	Сергей	Александрович	АВТ-1
Кабанин	Максим	Викторович	АВТ-1
Лопаткин	Евгений	Александрович	АВТ-1
Шолохов	Вячеслав	Дмитриевич	АВТ-2
Шаргало	Сергей	Васильевич	АВТ-2
Жбанкин	Игорь	Михайлович	АВТ-2
Зарубин	Павел	Александрович	АВТ-2
Демашев	Владимир	Генадьевич	АВТ-2
Маврин	Александр	Андреевич	АВТ-2
Аменицкий	Сергей	Александрович	АВТ-2
Сорокин	Александр	Борисович	АВТ-2
Носков	Василий	Иванович	АВТ-2
Чернышев	Алексей	Николаевич	АВТ-2
Волков	Игорь	Витальевич	АВТ-2
Сорокин	Василий	Иванович	АВТ-2
Захаров	Сергей	Александрович	АВТ-2
Орехов	Максим	Юрьевич	АВТ-2
Демарев	Анатолий	Евгеньевич	АВТ-2
Елисеев	Владимир	Артемьевич	АВТ-2
Сыров	Александр	Леонтьевич	АВТ-2
Шумкин	Дмитрий	Анатольевич	АВТ-2
Редькин	Алексей	Владимирович	АВТ-2
Поляков	Игорь	Вячеславович	АВТ-2
Носков	Иван	Васильевич	АВТ-2
Попов	Сергей	Васильевич	АВТ-2
Дранишников	Андрей	Витальевич	АВТ-2
Иванов	И	И	АВТ-2
Царенков	Илья	Николаевич	АВТ-2
Солодовников	Павел	В	АВТ-2
Кучерук	Валерий	В	АВТ-2
Шеронов	Борис	Михайлович	ЭЛОУ
Ястребов	Валерий	Петрович	ЭЛОУ
Холодов	Владимир	Юрьевич	ЭЛОУ
Хмылов	Александр	Никифорович	ЭЛОУ
Миловидов	Анатолий	Александрович	ЭЛОУ
Иванов	Виктор	Александрович	ЭЛОУ
Инедеркин	Виктор	В	ЭЛОУ
